はつねみく	初音ミク	人名
かがみねりん	鏡音リン	人名
かがみねれん	鏡音レン	人名
めぐりねるか	巡音ルカ	人名
めいこ	MEIKO	人名
かいと	KAITO	人名


ほしのいちか	星乃一歌	人名
てんまさき	天馬咲希	人名
もちづきほなみ	望月穂波	人名
ひのもりしほ	日野森志歩	人名

はなさとみのり	花里みのり	人名
きりたにはるか	桐谷遥	人名
ももいあいり	桃井愛莉	人名
ひのもりしずく	日野森雫	人名

あずさわこはね	小豆沢こはね	人名
しらいしあん	白石杏	人名
しののめあきと	東雲彰人	人名
あおやぎとうや	青柳冬弥	人名

てんまつかさ	天馬司	人名
おおとりえむ	鳳えむ	人名
くさなぎねね	草薙寧々	人名
かみしろるい	神代類	人名

よいさきかなで	宵崎奏	人名
あさひなまふゆ	朝比奈まふゆ	人名
しののめえな	東雲絵名	人名
あきやまみずき	暁山瑞希	人名


いおり	イオリ	人名
みお	ミオ	人名
たかぎみう	高木未羽	人名
よしざきかの	吉崎花乃	人名
よしざきようた	吉崎葉太	人名
こうさかさく	高坂朔	人名
しんどうよしき	真堂良樹	人名

まい	真依	人名
はやかわななみ	早川ななみ	人名
うちやまゆいな	内山唯奈	人名
さいとうあやか	斎藤彩香	人名
はせがわりほ	長谷川里帆	人名
ひぐれありさ	日暮アリサ	人名

しらいしけん	白石謙	人名
みたこうたろう	三田洸太郎	人名
あおやなぎはるみち	青柳春道	人名
こたきたいが	古瀧大河	人名
こたきなぎ	古瀧凪	人名
とおのあらた	遠野新	人名
みやたそうま	宮田颯真	人名
おかざきたつや	岡崎達也	人名

ねねろぼ	ネネロボ	人名
せいりゅういんさくらこ	青龍院櫻子	人名
おおとりけいすけ	鳳慶介	人名
おおとりしょうすけ	鳳晶介	人名
おおとりひなた	鳳ひなた	人名
おおとりゆきのすけ	鳳幸之介	人名
じょんらいりー	ジョン・ライリー	人名
おおとりらくのすけ	鳳楽之介	人名
かざまつりゆうか	風祭夕夏	人名
げんぶあさひ	玄武旭	人名
しののめしんえい	東雲慎英	人名
なつのふたば	夏野二葉	人名
