てるゆあわーるど	Tell Your World	固有名詞
ネクストネスト	ネクストネスト	固有名詞
めると	メルト	固有名詞
はつねみくのしょうしつ	初音ミクの消失	固有名詞
ぶれっしんぐ	Blessing	固有名詞
あらいぶ	alive	固有名詞
ろき	ロキ	固有名詞
てお	テオ	固有名詞
ひばなりろーでっど	ヒバナ -Reloaded-	固有名詞
ひばな	ヒバナ	固有名詞
はっぴーしんせさいざ	ハッピーシンセサイザ	固有名詞
のすたろじっく	Nostalogic	固有名詞
つぎはぎすたっかーと	ツギハギスタッカート	固有名詞
れっとうじょうとう	劣等上等	固有名詞
どくたーふぁんくびーと	ドクター＝ファンクビート	固有名詞
ふらじーる	フラジール	固有名詞
ぶりきのだんす	ブリキノダンス	固有名詞
すいーとまじっく	スイートマジック	固有名詞
ぼうけんのしょがきえました！	ぼうけんのしょがきえました！	固有名詞
しゃるる	シャルル	固有名詞
はろはわゆ	ハロ／ハワユ	固有名詞
じしょうむしょく	自傷無色	固有名詞
にーどる	needLe	固有名詞
あいどるしんえいたい	アイドル新鋭隊	固有名詞
れでぃーすてでぃー	Ready Steady	固有名詞
せかいはまだはじまってすらいない	セカイはまだ始まってすらいない	固有名詞
くやむとかいてみらい	悔やむと書いてミライ	固有名詞
せかい	セカイ	固有名詞
わーわーわーるど	ワーワーワールド	固有名詞
あすのよぞらしょうかいはん	アスノヨゾラ哨戒班	固有名詞
にあ	ニア	固有名詞
だっぽうろっく	脱法ロック	固有名詞
じゃすとびーふれんず	Just Be Friends	固有名詞
いのちにきらわれている	命に嫌われている	固有名詞
わーるどいずまいん	ワールドイズマイン	固有名詞
だんすろぼっとだんす	ダンスロボットダンス	固有名詞
はんどいんはんど	Hand in Hand	固有名詞
よはなしてぃせいぶ	夜咄ディセイブ	固有名詞
じゃんきーないとたうんおーけすとら	ジャンキーナイトタウンオーケストラ	固有名詞
びばはぴ	ビバハピ	固有名詞
ぎんねぎんね	Gimme×Gimme	固有名詞
みらくるぺいんと	ミラクルペイント	固有名詞
おんざろっくす	on the rocks	固有名詞
けいたいこいばなし	携帯恋話	固有名詞
さんきゅぅみゅーじっく	38ミュージック！	固有名詞
さんきゅーみゅーじっく	39ミュージック！	固有名詞
あおくかけろ	青く駆けろ！	固有名詞
すてら	ステラ	固有名詞
れいありまいんど	Leia - Remind	固有名詞
じゃっくぽっとさっどがーる	ジャックポットサッドガール	固有名詞
めるてぃらんどないとめあ	メルティランドナイトメア	固有名詞
おとめかいぼう	乙女解剖	固有名詞
ぽてとになっていく	potatoになっていく	固有名詞
ろーりんがーる	ローリンガール	固有名詞
もあじゃんぷもあ	モア！ジャンプ！モア！	固有名詞
うらおもてらばーず	裏表ラバーズ	固有名詞
あんのうんまざーぐーす	アンノウン・マザーグース	固有名詞
あいされなくてもきみがいる	愛されなくても君がいる	固有名詞
うみゆりかいていたん	ウミユリ海底譚	固有名詞
ふぉわーど	Forward	固有名詞
ひとりんぼえん?ぃー	独りんぼエンヴィー	固有名詞
おっずあんどえんず	ODDS＆ENDS	固有名詞
どらまつるぎー	ドラマツルギー	固有名詞
ぐりーんらいつせれなーで	グリーンライツ・セレナーデ	固有名詞
れんあいさいばん	恋愛裁判	固有名詞
はろーぷらねっと	＊ハロー、プラネット。	固有名詞
せんぼんざくら	千本桜	固有名詞
えこー	ECHO	固有名詞
ちゅるりらちゅるりらだっだっだ	チュルリラ・チュルリラ・ダッダッダ！	固有名詞
ぶれすゆあぶれす	ブレス・ユア・ブレス	固有名詞
とてもいたいいたがりたい	とても痛い痛がりたい	固有名詞
はれをまつ	霽れを待つ	固有名詞
わーるずえんどだんすほーる	ワールズエンド・ダンスホール	固有名詞
ひびかぜ	ヒビカセ	固有名詞
からーおぶどろっぷす	Color of Drops	固有名詞
らっどどっぐす	RAD DOGS	固有名詞
みるくくらうんおんそーねちか	ミルククラウン・オン・ソーネチカ	固有名詞
タイムマシン	タイムマシン	固有名詞
どろっぷぽっぷきゃんでぃー	drop pop candy	固有名詞
ポジティブダンスタイム	ポジティブ☆ダンスタイム	固有名詞
ぶらんどにゅーでー	Brand New Day	固有名詞
かぎりなくはいいろへ	限りなく灰色へ	固有名詞
わんすあぽんあどりーむ	ワンスアポンアドリーム	固有名詞
ぼっかでらべりた	ボッカデラベリタ	固有名詞
みくみくにしてあげる	みくみくにしてあげる♪ 【してやんよ】	固有名詞
いふうどうどう	威風堂々	固有名詞
ふろむわいとぅーわい	from Y to Y	固有名詞
はつねみくのげきしょう	初音ミクの激唱	固有名詞
てんしのくろーばー	天使のクローバー	固有名詞
おきにめすまま	お気に召すまま	固有名詞
どりーみんちゅちゅ	どりーみんチュチュ	固有名詞
あいでぃすまいる	アイディスマイル	固有名詞
いち	「１」	固有名詞
はなをうたう	花を唄う	固有名詞
よるにかける	夜に駆ける	固有名詞
ゆうれいとうきょう	幽霊東京	固有名詞
しねま	シネマ	固有名詞
きんぐ	KING	固有名詞
あいのまてりある	アイノマテリアル	固有名詞
いかないで	いかないで	固有名詞
ろみおとしんでれら	ロミオとシンデレラ	固有名詞
ほうまつみらい	泡沫未来	固有名詞
とんでもわんだーず	トンデモワンダーズ	固有名詞
かなでともすそら	カナデトモスソラ	固有名詞
とらふぃっくじゃむ	トラフィック・ジャム	固有名詞
ふろむとーきょー	フロムトーキョー	固有名詞
びーといーたー	Beat Eater	固有名詞
ろくちょうねんといちやものがたり	六兆年と一夜物語	固有名詞
ちきゅうさいごのこくはくを	地球最後の告白を	固有名詞
びたーちょこでこれーしょん	ビターチョコデコレーション	固有名詞
そうだった	そうだった！！	固有名詞
かげろうでいず	カゲロウデイズ	固有名詞
あいすどろっぷ	アイスドロップ	固有名詞
ぐろーりーすてでぃーごー	Glory Steady Go!	固有名詞
ちるどれんれこーど	チルドレンレコード	固有名詞
りゅうせいのぱるす	流星のパルス	固有名詞
かとらりー	カトラリー	固有名詞
さいせい	再生	固有名詞
ぐんじょうさんか	群青讃歌	固有名詞
ろしんゆうかい	炉心融解	固有名詞
ろすとわんのごうこく	ロストワンの号哭	固有名詞
ましんがんぽえむどーる	マシンガンポエムドール	固有名詞
べのむ	ベノム	固有名詞
はいけいどっぺるげんがー	拝啓ドッペルゲンガー	固有名詞
てれきゃすたーびーぼーい	テレキャスタービーボーイ	固有名詞
ときをふぁんか	トキヲ・ファンカ	固有名詞
あくまのおどりかた	悪魔の踊り方	固有名詞
だれかのしんぞうになれたなら	だれかの心臓になれたなら	固有名詞
ましゅまりー	マシュマリー	固有名詞
みぎかたのちょう	右肩の蝶	固有名詞
れい	ray	固有名詞
はろーわーるど	"Hello,world!"	固有名詞
しっくすおぶはうす	しっくおぶはうす！	固有名詞
しょうたいむるーらー	ショウタイム・ルーラー	固有名詞
はっぴはろうぃーん	Happy Halloween	固有名詞
ろうわー	ロウワー	固有名詞
はつねてんちかいひゃくしんわ	初音天地開闢神話	固有名詞
おるたーえご	オルターエゴ	固有名詞
すてーじおぶせかい	STAGE OF SEKAI	固有名詞
からくりぴえろ	からくりピエロ	固有名詞
わーるどわいどわんだー	ワールドワイドワンダー	固有名詞
あくのむすめ	悪ノ娘	固有名詞
あくのめしつかい	悪ノ召使	固有名詞
さりしひとたちのわるつ	去りし人達のワルツ	固有名詞
らすとすこあ	ラストスコア	固有名詞
ふぃくさー	フィクサー	固有名詞
みらい	ミライ	固有名詞
ごーすとるーる	ゴーストルール	固有名詞
?ぃらん	ヴィラン	固有名詞
さんどりよん	サンドリヨン 10th Anniversary	固有名詞
しょうじょれい	少女レイ	固有名詞
がらんど	ガランド	固有名詞
えんどまーくにきぼうとなみだをそえて	エンドマークに希望と涙を添えて	固有名詞
ざえんぺらー	the EmpErroR	固有名詞
どんとふぁいとざみゅーじっく	Don't Fight The Music	固有名詞
にっこりちょうさたいのてーま	にっこり^^調査隊のテーマ	固有名詞
とりころーじゅ	トリコロージュ	固有名詞
しんぱくすうなんばーぜろはちにに	心拍数♯0822	固有名詞
うっせぇわ	うっせぇわ	固有名詞
おど	踊	固有名詞
きみいろまりんすのう	君色マリンスノウ	固有名詞
あいしてあいしてあいして	愛して愛して愛して	固有名詞
ふらいやー	Flyer!	固有名詞
ぴーきーぴーきー	Peaky Peaky	固有名詞
じうだす	ジウダス	固有名詞
ナンセンス文学	ナンセンス文学	固有名詞
こころよほう	心予報	固有名詞
ぼくらまだあんだーぐらうんど	僕らまだアンダーグラウンド	固有名詞
みく	Miku	固有名詞
めたもりぼん	メタモリボン	固有名詞
いーあるふぁんくらぶ	いーあるふぁんくらぶ	固有名詞
あめとぺとら	雨とペトラ	固有名詞
のまど	ノマド	固有名詞
まとりょしか	マトリョシカ	固有名詞
どーなつほーる	ドーナツホール	固有名詞
すなのわくせい	砂の惑星	固有名詞
るかるかないとふぃーばー	ルカルカ★ナイトフィーバー	固有名詞
ぴあのふぉるてすきゃんだる	ピアノ×フォルテ×スキャンダル	固有名詞
せんねんのどくそうか	千年の独奏歌	固有名詞
はちじゅうはち	88☆彡	固有名詞
わんせるふ	ONESELF	固有名詞
PaⅢ.SENSATION	PaⅢ.SENSATION	固有名詞
だーりんだんす	ダーリンダンス	固有名詞
おーだーめいど	オーダーメイド	固有名詞
あいでんてぃてぃ	アイデンティティ	固有名詞
あおいろえのぐ	青色絵具	固有名詞
こすもすぱいす	コスモスパイス	固有名詞
とくがわかっぷぬーどるきんしれい	徳川カップヌードル禁止令	固有名詞
さらまんだー	サラマンダー	固有名詞
いふ	イフ	固有名詞
ぶらっくろっくしゅーたー	ブラック★ロックシューター	固有名詞
もうそうかんしょうだいしょうれんめい	妄想感傷代償連盟	固有名詞
りもこん	リモコン	固有名詞
げっこう	月光	固有名詞
あさがおのちるころに	アサガオの散る頃に	固有名詞
かみのまにまに	神のまにまに	固有名詞
あうぇいくなう	Awake Now	固有名詞
あうんのびーつ	阿吽のビーツ	固有名詞
ばぐ	バグ	固有名詞
ぐっばいせんげん	グッバイ宣言	固有名詞
?ぁんぱいあ	ヴァンパイア	固有名詞
みかんせいさんか	未完成讃歌	固有名詞
ほしぞらのめろでぃー	星空のメロディー	固有名詞
のうしょうさくれつがーる	脳漿炸裂ガール	固有名詞
ぼくらのじゅうろくびっとせんそう	ぼくらの16bit戦争	固有名詞
めりゅー	メリュー	固有名詞
えいりあんえいりあん	エイリアンエイリアン	固有名詞
まち	街	固有名詞
てらてら	てらてら	固有名詞
ふろいらいんびぶりぉちか	フロイライン＝ビブリォチカ	固有名詞
おどれおーけすとら	踊れオーケストラ	固有名詞
ぱらそるさいだー	パラソルサイダー	固有名詞
ろすとえんふぁうんど	ロストエンファウンド	固有名詞
わいわい	YY	固有名詞
それでもいいんだよ	それでもいいんだよ	固有名詞
きみのよるをくれ	君の夜をくれ	固有名詞
ふゅーちゃーい?	フューチャー・イヴ	固有名詞
ぼいしっず	Voices	固有名詞
じぇへな	ジェヘナ	固有名詞
かるく	Calc.	固有名詞
うつろをあおぐ	虚ろを扇ぐ	固有名詞
じゃーにー	Journey	固有名詞
あまのじゃく	天ノ弱	固有名詞
あんはっぴーりふれいん	アンハッピーリフレイン	固有名詞
ふぉにい	フォニイ	固有名詞
だぶるらりあっと	ダブルラリアット	固有名詞
いんびじぶる	インビジブル	固有名詞
えごろっく	エゴロック	固有名詞
ばっど ∞ えんど ∞ ないと	Bad ∞ End ∞ Night	固有名詞
とりのこしてぃ	トリノコシティ	固有名詞
こちら、こうふくあんしんいいんかいです。	こちら、幸福安心委員会です。	固有名詞
でいぶれいくふろんとらいん	DAYBREAK FRONTLINE	固有名詞
あまらだいみらいでんのう	?MARA(大未来電脳)	固有名詞
どりーむぷれいす	DREAM PLACE	固有名詞
どんなけつまつがおのぞみだい？	どんな結末がお望みだい？	固有名詞
でいちゅうにさく	泥中に咲く	固有名詞
いちにのさんで	いちにのさんで	固有名詞
ていこくしょうじょ	帝国少女	固有名詞
ちぇんじみー	Change me	固有名詞
らぶか	ラブカ？	固有名詞
ざうぉーる	the WALL	固有名詞
あいなんです	Iなんです	固有名詞
ぱらじくろろべんぜん	パラジクロロベンゼン	固有名詞
ほしくずゆーとぴあ	星屑ユートピア	固有名詞
ふれー	フレー	固有名詞
あったかいと	あったかいと	固有名詞
ふろーとぷらんなー	フロート・プランナー	固有名詞
ふろーと・ぷらんなー	フロート・プランナー	固有名詞
のんぶれす・おぶりーじゅ	ノンブレス・オブリージュ	固有名詞
のんぶれすおぶりーじゅ	ノンブレス・オブリージュ	固有名詞
ろんりーゆにばーす	ロンリーユニバース	固有名詞
ひだまりのせつな	陽だまりのセツナ	固有名詞
かしか	仮死化	固有名詞
わっつあっぷぽっぷ	What's up? Pop!	固有名詞
わっつあっぷ・ぽっぷ	What's up? Pop!	固有名詞
くされげどうとちょこれいと	腐れ外道とチョコレゐト	固有名詞
くされげどうとちょこれゐと	腐れ外道とチョコレゐト	固有名詞
よるもすがらきみおもう	夜もすがら君想ふ	固有名詞
よるもすがらきみおもふ	夜もすがら君想ふ	固有名詞
ねとげはいじんしゅぷれひこーる	ネトゲ廃人シュプレヒコール	固有名詞
かんたれら	カンタレラ	固有名詞
ふりーりーとぅもろー	FREELY TOMORROW	固有名詞
ふりーりー・とぅもろー	FREELY TOMORROW	固有名詞
きまぐれめるしぃ	気まぐれメルシィ	固有名詞
きまぐれめるしい	気まぐれメルシィ	固有名詞
それがあなたのしあわせとしても	それがあなたの幸せとしても	固有名詞
りんちゃんなう！	リンちゃんなう！	固有名詞
ふぇれす	フェレス	固有名詞
よあけとほたる	夜明けと蛍	固有名詞
ほしぞらおーけすとら	星空オーケストラ	固有名詞
ふらいうぇい	Flyway	固有名詞
ぴーえいち	p.h.	固有名詞
ぺーはー	p.h.	固有名詞
ぐっばい	Goodbye	固有名詞
ぐっどばい	Goodbye	固有名詞
すのーみっくす	SnowMix♪	固有名詞
せかいちゃんとかふちゃんのおつかいがっそうきょく	星界ちゃんと可不ちゃんのおつかい合騒曲	固有名詞
てんしのつばさ	天使の翼。	固有名詞
こぴーきゃっと	Copycat	固有名詞
れいにーすのーどろっぷ	レイニースノードロップ	固有名詞
あいろに	アイロニ	固有名詞
いちきゅうにーごー	1925	固有名詞
わたしはわたしたちは	私は、私達は	固有名詞
わたしは、わたしたちは	私は、私達は	固有名詞
ひつじがいっぴき	ひつじがいっぴき	固有名詞
はろーわーかー	"Hello, Worker"	固有名詞
うぇあしゃるうぃーごー	Where shall we go?	固有名詞
こころ	ココロ	固有名詞
すとらぼらすと	ストロボラスト	固有名詞
ぱれっとにはきみがいっぱい	パレットには君がいっぱい	固有名詞
きゅー	Q	固有名詞
Ｑ	Q	固有名詞
やみなべ	ヤミナベ!!!!	固有名詞
ぶー	Booo!	固有名詞
さんきゅー	39	固有名詞
さんじゅうきゅう	39	固有名詞
みく	39	固有名詞
みすたーしょーたいむ	Mr. Showtime	固有名詞
みすたーしょうたいむ	Mr. Showtime	固有名詞
えごいすと	エゴイスト	固有名詞
えぴろーぐにきみはいない	エピローグに君はいない	固有名詞
はいらいと	Highlight	固有名詞
あとらくとらいと	アトラクトライト	固有名詞
ざむざ	ザムザ	固有名詞
とらっしゅあんどとらっしゅ	トラッシュ・アンド・トラッシュ！	固有名詞
?ぁんぱいあぱとす	Vampire's ∞ pathoS	固有名詞
びーざみゅーじっく	Be The MUSIC!	固有名詞
めてお	METEOR	固有名詞
いんたびゅあ	インタビュア	固有名詞
わたしのこいはへるふぁいあ	私の恋はヘルファイア	固有名詞
すのーまん	スノーマン	固有名詞
しんかいしょうじょ	深海少女	固有名詞
まほうみたいなみゅーじっく	魔法みたいなミュージック！	固有名詞
あいおい	相生	固有名詞
なもなきかくめい	名も無き革命	固有名詞
おこちゃませんそう	おこちゃま戦争	固有名詞
たえまなくあいいろ	絶え間なく藍色	固有名詞
いのちばっかり	命ばっかり	固有名詞
ももいろのかぎ	ももいろの鍵	固有名詞
きてぃ	キティ	固有名詞
かいせい	快晴	固有名詞
あくじきむすめこんちーた 	悪食娘コンチータ	固有名詞
ねむらせひめからのおくりもの	眠らせ姫からの贈り物	固有名詞
えんひさかのしたてや 	円尾坂の仕立屋	固有名詞
あくとくのじゃっじめんと	悪徳のジャッジメント 　	固有名詞
しぇありんぐざわーるど	Sharing The World	固有名詞
せつなとりっぷ	セツナトリップ	固有名詞
しゃんてぃ	シャンティ	固有名詞
えたーなるえりあ	エターナルアリア	固有名詞
ぶるーすたー	Blue Star	固有名詞
はこにわのこらる	箱庭のコラル	固有名詞
じんせい	人生	固有名詞
わんだーすたいる	Wonder Style	固有名詞
げこくじょう	下剋上	固有名詞
ああすばらしきにゃんせい	嗚呼、素晴らしきニャン生	固有名詞
すたーだすとめどれー	スターダストメドレー	固有名詞
ちーむめいと	チームメイト	固有名詞
ぐろー	glow	固有名詞
とてもすてきなろくがつでした	とても素敵な六月でした	固有名詞
あんだーうぉーたー	UNDERWATER	固有名詞
きゅうくらりん	きゅうくらりん	固有名詞
あふたーぐろー	Afterglow	固有名詞
たいようけいですこ	太陽系デスコ	固有名詞
しんぱくぺありんぐ	心拍ペアリング	固有名詞
えんげき	演劇	固有名詞
ほしをつなぐ	星を繋ぐ	固有名詞
のうないかくめいがーる	脳内革命ガール	固有名詞
でぃけーど	Decade	固有名詞
でけーど	Decade	固有名詞
われらすていんばすたーず	我らステインバスターズ！	固有名詞
しんじんるい	新人類	固有名詞
ずんだぱーりない	ずんだパーリナイ	固有名詞
でぃすこなんばーさんじゅうきゅう	Disco No.39	固有名詞
でぃすこなんばーさんきゅう	Disco No.39	固有名詞
でぃすこなんばーみく	Disco No.39	固有名詞
でぃすこさんじゅうきゅう	Disco No.39	固有名詞
でぃすこさんきゅう	Disco No.39	固有名詞
でぃすこみく	Disco No.39	固有名詞
さまーたいむれこーど	サマータイムレコード	固有名詞
りあらいず	リアライズ	固有名詞
きらぴぴきらぴか	キラピピ★キラピカ	固有名詞
ぼとるけーき	ボトルケーキ	固有名詞
こころなし	心做し	固有名詞
ぶるーぷらねっと	ブループラネット	固有名詞
ひーろー	HERO	固有名詞
さーかすぱにっく	CIRCUS PANIC!!!	固有名詞
しろいゆきのぷりんせすは	白い雪のプリンセスは	固有名詞
あんろっく	Un-Lock	固有名詞
らっきーおーぶ	ラッキー☆オーブ	固有名詞
ねお	NEO	固有名詞
あいむまいん	アイムマイン	固有名詞
てんがく	天樂	固有名詞
まにまに	まにまに	固有名詞
めらんこりっく	メランコリック	固有名詞
ぶたになっていぇーいぇー	豚になってyeah yeah	固有名詞
ぶたになっていぇいいぇい	豚になってyeah yeah	固有名詞
こいはせんそう	恋は戦争	固有名詞
でびるじゃないもん	デビルじゃないもん	固有名詞
すきなことだけでいいです	すきなことだけでいいです	固有名詞
つがいこがらし	番凩	固有名詞
つがゐこがらし	番凩	固有名詞
かみっぽいな	神っぽいな	固有名詞
でぃあー	Dear	固有名詞
くれいじー	CR詠ZY	固有名詞
くれーじー	CR詠ZY	固有名詞
くれえじー	CR詠ZY	固有名詞
くーるみーだうん	Cool Me Down	固有名詞
あくやくにきすしーんを	悪役にキスシーンを	固有名詞
わがままひめ	我儘姫	固有名詞
ぱーぱす	purpose	固有名詞
ぱーぽす	purpose	固有名詞
はぐ	はぐ	固有名詞
とわいらいとらいと	トワイライトライト	固有名詞
はるあらし	春嵐	固有名詞
あーきたいぷ	ARQETYPE	固有名詞
おんおん	On&On	固有名詞
きゅーとなかのじょ	キュートなカノジョ	固有名詞
ふぃらめんとふぃーばー	フィラメントフィーバー	固有名詞
さよならぷりんせす	さよならプリンセス	固有名詞
びよんどざうぇい	Beyond the way	固有名詞
びよんざうぇい	Beyond the way	固有名詞
しょうたいむおーでぃえんす	ショウタイム×オーディエンス	固有名詞
なんちょうけいだんしがたおせない	難聴系男子が倒せない	固有名詞
おーばーこーど	オーバーコード	固有名詞
すろうだうなー	スロウダウナー	固有名詞
はじめてのこいがおわるとき	初めての恋が終わる時	固有名詞
25時の情熱	にじゅうごじのじょうねつ	固有名詞

