ばーちゃるしんがー	VIRTUAL SINGER
れおにーど	Leo/need
もあもあじゃんぷ	MORE MORE JUMP!
もあもあじゃんぷ	MORE MORE JUMP！
びびっどばっどすくあっど	Vivid BAD SQUAD
わんだーらんずしょうたいむ	ワンダーランズ×ショウタイム
にじゅうごじないとこーどで	25時、ナイトコードで。

ばちゃしん	VIRTUAL SINGER
れおに	Leo/need
もあじゃん	MORE MORE JUMP！
もあじゃん	MORE MORE JUMP!
ももじゃん	MORE MORE JUMP！
ももじゃん	MORE MORE JUMP!
びびばす	Vivid BAD SQUAD
わんだしょ	ワンダーランズ×ショウタイム
にーご	25時、ナイトコードで。
にご	25時、ナイトコードで。

あおはるふれんず	青春/friends
ゆめゆめじゃんぷ	YUME YUME JUMP!
ゆめゆめじゃんぷ	YUME YUME JUMP！
ふぁんたじすたすくあっど	Fantasista SQUAD
はぴねすせんたいさにさにわんだー	ハピネス戦隊サニサニ☆ワンダー
きゅうじつしゅみじんどうしで	休日、趣味人同士で。
